WWWWWWWWWWWWWWWWWWWWWWWWW
WSSSSSBSSSBBSSSSBBSSSSSSW
WSSSSBBBBSSBSSBSSSSSSSSSW
WSSSWWWWWWWWWWWWWWWSSSSSW
WSSSBBBSSSSSSSSSSSSSSSSSW
WSSSBBBBSSSSSSSSSBBSSSSSW
WSSSWWWWWSBBBWWWWWWSSSSSW
WSSSBSSSBSSSSSSSBBSSSSSSW
WSSSWWWWWBSSSSBBBSSSSSSSW
WSSSSBBBBSBSSSSSWSSSSSSSW
WSSSBSSSSSSSSSSSWSSSSSSSW
WSSSSSSSSWWWWWWWWWSSSSSSW
WSSSWSSSSSBSWWSSWSSSSSSSW
WSSSWSSSSSBSSSSSWWWSSSSSW
WSSSWSSSSSBSSSSSSBSSSSSSW
WSSSWWWWWWSSSSSSSBSSSSSSW
WSSSSSSSSSSSBBBWWWWSSSSSW
WSSSSSBBBSSSSSSSSSSSSSSSW
WWWWWWWWWWWWWWWWWWWWWWWWW
